111111111111111111
10P0C0000C00000001
100000000000000001
10000C00000000C001
100000000000000001
100000000000000C11
100001111111111111
100000000011111111
10000C000111100111
10E001111111111111
111111111111111111