111111
100011
10P011
1C0eE1
111111